{
    "compose_ids": [
        134257216, 
        134268943, 
        134233952, 
        134244701, 
        134280428, 
        201390095, 
        201390094, 
        201390093, 
        201390091, 
        201390090, 
        201390089, 
        201390087, 
        201390088, 
        201390085, 
        201390086, 
        201390081, 
        201390082, 
        134245059, 
        134238903, 
        201390083, 
        201390084, 
        201390096, 
        201390097, 
        134278589, 
        134257065, 
        134264126, 
        134253385, 
        134243995, 
        134267045, 
        134275213, 
        134278629, 
        134280087, 
        134218218, 
        134262923, 
        134262215, 
        134233763, 
        134255180, 
        134224775, 
        134218624, 
        134221867, 
        134240232, 
        134257384, 
        134234796, 
        134229235, 
        134253920, 
        134275099, 
        134273700, 
        201390092, 
        134258256, 
        134276637, 
        134269247, 
        134250786, 
        134257230, 
        134250168, 
        134233693, 
        134277246, 
        201390023, 
        201390024, 
        201390001, 
        201390002, 
        134245520, 
        134253209, 
        134266379, 
        134240669, 
        134280991
    ], 
    "item_id_seed": 0
}